2222222222222222222222222222222222222222
2121111111111111111221111111111111111212
2121222222222222121221212222222222221212
2121211111111111121221211111111111121212
2111112122222212111111112122222212111112
2121212111111112121221211111111112121212
2111112222212222111221112222122222111112
2121211111111111121221211111111111121212
2121212222222222221111222222222222121212
2121212111111111111111111111111112121212
2121212122222222122222212222222212121212
2111111111111111111111111111111111111112
2122222221222122222222222122212222222212
2121111111111111111221111111111111111212
2122222221222222221221222222212222222212
2111111111111111121221211111111111111112
2121222222222222121221212222222222221212
2121111111111211111111111112111111111112
2121222222222212222212222122222222221212
2121211111111112111011112111111111121212
2111211111111112111211112111111111121112
2121222222222212222222222122222222221212
2121111111111211111111111112111111111112
2121222222222222121221212222222222221212
2111111111111111121221211111111111111112
2122222221222222221221222222212222222212
2121111111111111111221111111111111111212
2122222221222122222222222122212222222212
2111111111111111111111111111111111111112
2121212122222222122222212222222212121212
2121212111111111111111111111111112121212
2121212222222222221111222222222222121212
2121211111111111121221211111111111121212
2111112222212222111221112222122222111112
2121212111111112121221211111111112121212
2111112122222212111111112122222212111112
2121211111111111121221211111111111121212
2121222222222222121221212222222222221212
2121111111111111111221111111111111111212
2222222222222222222222222222222222222222
